NO texture/north.xpm
SO texture/south.xpm
WE texture/west.xpm
EA texture/east.xpm

F 157,216,75
C 153,204,254

   11111111111111111111111111111111111111111111
  1N0000000000000000000000000000000010001
  111111111111111111111111111111111111111111