NO texture/north.xpm
SO texture/south.xpm
WE texture/west.xpm
EA texture/east.xpm

F 157,216,75
C 153,204,255

        1111111111111111111111111
        10000000000100000001110101
        1011000001110000000110001
        1001000000000000000110001
111111110011000001110000000000001
10000000001100N001110111111101111
10110111111111011100000010001
11110111111111011101010010001
11000000110101011100000010001
10000000000000001100000000001
100000000000000011010100101011
1100000010010100101101111101001
10110111 1110101 1011110101011
11111111 1111111 111111111111
