NO texture/north.xpm
SO texture/south.xpm
WE texture/west.xpm
EA texture/east.xpm

F 157,216,75
C 153,204,255

1111111111111111111111111111111111
1000000000000001N10000000000000001
1000000011110000100000001111000001
1000000000000000000000000000000001
1000000000000000000000000000000001
1000000011110000000000001111000001
1000000000000000000000000000000001
1111111111111111111111111111111111
